9 16

P P P P P P P P P P P P B B B B
P P P P P P P P P P P P B B B B
B B B B B B B B B B P P B B B B
B B B B B B B B B B P P B B B B
B B B B B B B B B B P P P P P P
B B B B B B B B B B P P P P P P
B B B B B B B B B B B B B B B B
B B B B B B B B B B B B B B B B
B B B B B B B B B B B B B B B B

0 0
5 15

5

TIME  5 BASIC  5 END
TIME 10 BASIC 10 END
TIME 10 BASIC 15 END
TIME 10 BASIC 20 END
TIME 10  FAST 10 END