9 16
P P P P B B B B B P P P B B B B
P P P P B B B B B P B P B B B B
B B P P B B B B B P B P B B B B
B B P P B P P P P P B P B B B B
P P P P B P B B B B P P B B B B
P P P P B P B B B B P B B B B B
P B B B B P B B B B P B B B B B
P B B B B P B B B B P B B B B B
P P P P P P B B B B P P P P P P
0 0
8 15