9 16
P P P P P B B B B B B B B B B B
B B B B P B B B B B B B B B B B
B B B B P B B P P P P P P P B B
B P P P P B B P B B B B B P B B
B P B B B B B P B B B B B P B B
B P B B B B B P B B B B B P B B
B P P P P P P P B B B B B P B B
B B B B B B B B B B B B B P B B
B B B B B B B B B B B B B P B B
0 0
8 13